12 12 12 12 12 12 12 12 12 12 12 12 12 12 12 12 12 12 12 12 12 12 12 12 12 12 12 12 12 12 12 12 12 12 12 12 12 12 12 12 12 12 12 12 12 12 12 12 12 12 12 12 12 12 12 12 12 12 12 12 12 12 12 12 12 12 12 12 12 12 12 12 12 12 12 12 12 12 12 12 12 12 12 12 12 12 12 12 12 12 12 12 12 12 12 12 12 12 12 12
12 12 12 12 12 12 12 12 12 12 12 12 12 12 12 12 12 12 12 12 12 12 12 12 12 12 12 12 12 12 12 12 12 12 12 12 12 12 12 12 12 12 12 12 12 12 12 12 12 12 12 12 12 12 12 12 12 12 12 12 12 12 12 12 12 12 12 12 12 12 12 12 12 12 12 12 12 12 12 12 12 12 12 12 12 12 12 12 12 12 12 12 12 12 12 12 12 12 12 12
12 12 12 12 12 12 12 12 12 12 12 12 12 12 12 12 12 12 12 12 12 12 12 12 12 12 12 12 12 12 12 12 12 12 12 12 12 12 12 12 12 12 12 12 12 12 12 12 12 12 12 12 12 12 12 12 12 12 12 12 12 12 12 12 12 12 12 12 12 12 12 12 12 12 12 12 12 12 12 12 12 12 12 12 12 12 12 12 12 12 12 12 12 12 12 12 12 12 12 12
12 12 12 12 12 12 12 12 12 12 12 12 12 12 12 12 12 12 12 12 12 12 12 12 12 12 12 12 12 12 12 12 12 12 12 12 12 12 12 12 12 12 12 12 12 12 12 12 12 12 12 12 12 12 12 12 12 12 12 12 12 12 12 12 12 12 12 12 12 12 12 12 12 12 12 12 12 12 12 12 12 12 12 12 12 12 12 12 12 12 12 12 12 12 12 12 12 12 12 12
12 12 12 12 10 10 10 10 10 10 10 10 10 10 10 10 10 10 10 41 10 41 41 10 41 10 10 10 10 10 10 10 10 10 10 10 10 10 10 41 40 40 10 10 10 10 10 10 10 10 10 40 40 41 41 41 41 41 41 41 41 41 41 41 41 12 12 12 12 10 10 10 10 10 10 10 10 10 10 10 10 10 10 10 10 10 10 10 10 10 10 10 10 10 10 10 12 12 12 12
12 12 12 12 10 10 10 10 10 10 10 10 10 10 10 10 10 10 10 42 41 42 42 41 42 10 10 10 10 10 10 10 10 10 10 10 10 10 10 42 40 40 10 10 10 10 10 10 10 10 10 40 40 42 42 42 42 42 42 42 42 42 42 42 42 12 12 12 12 10 10 10 10 10 10 10 10 10 10 10 10 10 10 10 10 10 10 10 10 10 10 10 10 10 10 10 12 12 12 12
12 12 12 12 10 10 10 26 26 26 26 26 26 26 26 26 26 10 10 10 42 10 10 42 41 10 10 10 10 10 10 10 10 10 10 10 10 10 10 41 40 40 10 10 10 10 10 10 10 10 10 40 40 41 10 10 10 10 10 10 10 10 10 10 10 12 12 12 12 10 10 10 10 10 10 10 10 10 10 10 10 10 10 10 10 10 10 10 10 10 10 10 10 10 10 10 12 12 12 12
12 12 12 12 10 10 10 26 26 26 26 26 26 26 26 26 26 10 10 10 41 41 41 41 42 10 10 10 10 10 10 10 10 10 10 10 10 10 10 42 40 40 10 10 10 10 10 10 10 10 10 40 40 42 10 10 10 10 10 10 10 10 10 10 10 12 12 12 12 10 10 10 10 10 10 10 10 10 10 10 10 10 10 10 10 10 10 10 10 10 10 10 10 10 10 10 12 12 12 12
12 12 12 12 10 10 10 26 26 26 26 26 26 26 26 26 26 10 10 10 42 42 42 42 41 10 10 10 10 10 10 10 10 10 10 10 10 10 10 41 40 40 26 26 26 26 26 26 26 26 26 40 40 41 10 10 10 10 10 10 10 10 10 10 10 12 12 12 12 10 10 10 10 10 10 10 10 10 10 10 10 10 10 10 10 10 10 10 10 10 10 10 10 10 10 10 12 12 12 12
12 12 12 12 10 10 10 26 26 26 26 26 26 26 26 26 26 10 10 10 41 41 41 41 42 10 10 10 10 10 10 10 10 10 10 10 10 10 10 42 40 40 26 26 26 26 26 26 26 26 26 40 40 42 10 10 10 10 10 10 10 10 10 10 10 12 12 12 12 10 10 10 10 10 10 10 10 10 10 10 10 10 10 10 10 10 10 10 10 10 10 10 10 10 10 10 12 12 12 12
12 12 12 12 10 10 10 10 10 10 10 10 10 10 10 10 10 10 10 10 42 42 42 42 10 10 10 10 10 10 10 10 10 10 10 10 10 10 10 41 10 10 10 10 10 10 10 10 10 10 10 10 10 41 10 10 10 10 10 10 10 10 10 10 10 12 12 12 12 10 10 10 10 10 10 10 10 10 10 10 10 10 10 10 10 10 10 10 10 10 10 10 10 10 10 10 12 12 12 12
12 12 12 12 10 10 10 10 10 10 10 10 10 10 10 10 10 10 10 10 41 41 41 41 10 10 10 10 10 10 10 10 10 10 10 10 10 10 10 42 10 10 10 10 10 10 10 10 10 10 10 10 10 42 10 10 10 10 10 10 10 10 10 10 10 12 12 12 12 10 10 10 10 10 10 10 10 10 10 10 10 10 10 10 10 10 10 10 10 10 10 10 10 10 10 10 12 12 12 12
12 12 12 12 10 10 10 10 10 10 10 10 10 10 10 10 10 10 10 10 42 42 42 42 10 10 10 10 10 10 10 10 10 10 10 10 10 10 10 41 10 10 10 10 10 10 10 10 10 10 10 10 10 41 10 10 10 10 10 10 10 10 10 10 10 12 12 12 12 10 10 10 10 10 10 10 10 10 10 10 10 10 10 10 10 10 10 10 10 10 10 10 10 10 10 10 12 12 12 12
12 12 12 12 10 10 10 10 10 10 10 10 10 10 10 10 10 10 10 10 41 41 41 41 10 10 10 10 10 10 10 10 10 10 10 10 10 10 10 42 10 10 10 10 10 10 10 10 10 10 10 10 10 42 10 10 10 10 10 10 10 10 10 10 10 12 12 12 12 10 10 10 10 10 10 10 10 10 10 10 10 10 10 10 10 10 10 10 10 10 10 10 10 10 10 10 12 12 12 12
12 12 12 12 10 10 10 10 10 10 10 10 10 10 10 10 10 10 10 10 42 42 42 42 10 10 10 10 10 10 10 10 10 10 10 10 10 10 10 10 10 10 10 10 10 10 10 10 10 10 10 10 10 10 10 10 10 10 10 10 10 10 10 39 39 39 39 39 39 39 39 10 10 10 10 10 10 10 10 10 10 10 10 10 10 10 10 10 10 10 10 10 10 10 10 10 12 12 12 12
12 12 12 12 10 10 10 10 10 10 10 10 10 10 10 10 10 10 10 10 41 41 41 41 10 10 10 10 10 10 10 10 10 10 10 10 10 10 10 10 10 10 10 10 10 10 10 10 10 10 10 10 10 10 10 10 10 10 10 10 10 10 10 39 39 39 39 39 39 39 39 10 10 10 10 10 10 10 10 10 10 10 10 10 10 10 10 10 10 10 10 10 10 10 10 10 12 12 12 12
12 12 12 12 10 10 10 10 10 10 10 10 10 10 10 10 10 10 10 10 42 42 42 42 10 10 10 10 10 10 10 10 10 10 10 10 10 10 10 10 10 10 10 10 10 10 10 10 10 10 10 10 10 10 10 10 10 10 10 10 10 10 10 39 39 39 39 39 39 39 39 10 10 10 10 10 10 10 10 10 10 10 10 10 10 10 10 10 10 10 10 10 10 10 10 10 12 12 12 12
12 12 12 12 10 10 10 10 10 10 10 10 10 10 10 10 10 10 10 10 41 41 41 41 10 10 10 10 10 10 10 10 10 10 10 10 10 10 10 10 10 10 10 10 10 10 10 10 10 10 10 10 10 10 10 10 10 10 10 10 10 10 10 39 39 39 39 39 39 39 39 10 10 10 10 10 10 10 10 10 10 10 10 10 10 10 10 10 10 10 10 10 10 10 10 10 12 12 12 12
12 12 12 12 10 10 10 10 10 10 10 10 10 10 10 10 10 10 10 10 42 42 42 42 10 10 10 10 10 10 10 10 10 10 10 10 10 10 10 41 10 10 10 10 10 10 10 10 10 10 10 10 10 41 41 10 10 10 10 10 10 10 10 10 10 12 12 12 12 10 10 10 10 10 10 10 10 10 10 10 10 10 10 10 10 10 10 10 10 10 10 10 10 10 10 10 12 12 12 12
12 12 12 12 10 10 10 10 10 10 10 10 10 10 10 10 10 10 10 10 41 41 41 41 10 10 10 10 10 10 10 10 10 10 10 10 10 10 10 42 10 10 10 10 10 10 10 10 10 10 10 10 10 42 42 10 10 10 10 10 10 10 10 10 10 12 12 12 12 10 10 10 10 10 10 10 10 10 10 10 10 10 10 10 10 10 10 10 10 10 10 10 10 10 10 10 12 12 12 12
12 12 12 12 10 10 10 10 10 10 10 10 10 10 10 10 10 10 10 10 42 42 42 42 10 10 10 10 10 10 10 10 10 10 10 10 10 10 10 41 10 10 10 10 10 10 10 10 10 10 10 10 10 41 41 10 10 10 10 10 10 10 10 10 10 12 12 12 12 10 10 10 10 10 10 10 10 10 10 10 10 10 10 10 10 10 10 10 10 10 10 10 10 10 10 10 12 12 12 12
12 12 12 12 10 10 10 10 10 10 10 10 10 10 10 10 10 10 10 10 41 41 41 41 10 10 10 10 10 10 10 10 10 10 10 10 10 10 10 42 10 10 10 10 10 10 10 10 10 10 10 10 10 42 42 10 10 10 10 10 10 10 10 10 10 12 12 12 12 10 10 10 10 10 10 10 10 10 10 10 10 10 10 10 10 10 10 10 10 10 10 10 10 10 10 10 12 12 12 12
12 12 12 12 10 10 10 10 10 10 10 10 10 10 10 10 10 10 10 10 42 42 42 42 10 10 10 10 10 10 10 10 10 10 10 10 10 10 10 41 10 10 10 10 10 10 10 10 10 10 10 10 10 41 41 10 10 10 10 10 10 10 10 10 10 12 12 12 12 10 10 10 10 10 10 10 10 10 10 10 10 10 10 10 10 10 10 10 10 10 10 10 10 10 10 10 12 12 12 12
12 12 12 12 10 10 10 10 10 10 10 10 10 10 10 10 10 10 10 10 41 41 41 41 10 10 10 10 10 10 10 10 10 10 10 10 10 10 10 42 10 10 10 10 10 10 10 10 10 10 10 10 10 42 42 10 10 10 10 10 10 10 10 10 10 12 12 12 12 10 10 10 10 10 10 10 10 10 10 10 10 10 10 10 10 10 10 10 10 10 10 10 10 10 10 10 12 12 12 12
12 12 12 12 10 10 10 10 10 10 10 10 10 10 10 10 10 10 10 10 42 42 42 42 10 10 10 10 10 10 10 10 10 10 10 10 10 10 10 41 10 10 10 10 10 10 10 10 10 10 10 10 10 41 41 10 10 10 10 10 10 10 10 10 10 12 12 12 12 10 10 10 10 10 10 10 10 10 10 10 10 10 10 10 10 10 10 10 10 10 10 10 10 10 10 10 12 12 12 12
12 12 12 12 10 10 10 10 10 10 10 10 10 10 10 10 10 10 10 10 41 41 41 41 10 10 10 10 10 10 10 10 10 10 10 10 10 10 10 42 10 10 10 10 10 10 10 10 10 10 10 10 10 42 42 10 10 10 10 10 10 10 10 10 10 12 12 12 12 10 10 10 10 10 10 10 10 10 10 10 10 10 10 10 10 10 10 10 10 10 10 10 10 10 10 10 12 12 12 12
12 12 12 12 10 10 10 10 10 10 10 10 10 10 10 10 10 10 10 10 42 42 42 42 10 10 10 10 10 10 10 10 10 10 10 10 10 10 10 41 10 10 10 10 10 10 10 10 10 10 10 10 10 41 41 10 10 10 10 10 10 10 10 10 10 12 12 12 12 40 40 40 10 10 40 40 40 40 40 40 40 40 40 40 40 40 40 40 40 40 40 10 10 40 40 40 12 12 12 12
12 12 12 12 10 10 10 10 10 10 10 10 10 10 10 10 10 10 10 10 41 41 41 41 10 10 10 10 10 10 10 10 10 10 10 10 10 10 10 42 10 10 10 10 10 10 10 10 10 10 10 10 10 42 42 10 10 10 10 10 10 10 10 10 10 12 12 12 12 40 40 40 10 10 10 10 10 10 10 10 10 10 10 10 10 10 10 10 10 10 10 10 10 40 40 40 12 12 12 12
12 12 12 12 10 10 10 10 10 10 10 10 10 10 10 10 10 10 10 10 42 42 42 42 10 10 10 10 10 10 10 10 10 10 10 10 10 10 10 41 10 10 10 10 10 10 10 10 10 10 10 10 10 41 41 10 10 10 10 10 10 10 10 10 10 12 12 12 12 40 40 40 10 10 10 10 10 10 10 10 10 10 10 10 10 10 10 10 10 10 10 10 10 40 40 40 12 12 12 12
12 12 12 12 10 10 10 10 10 10 10 10 10 10 10 10 10 10 10 10 41 41 41 41 10 10 10 10 10 10 10 10 10 10 10 10 10 10 10 42 10 10 10 10 10 10 10 10 10 10 10 10 10 42 42 10 10 10 10 10 10 10 10 10 10 12 12 12 12 40 40 40 10 10 10 10 10 10 10 10 10 10 10 10 10 10 10 10 10 10 10 10 10 40 40 40 12 12 12 12
12 12 12 12 10 10 10 10 10 10 10 10 10 10 10 10 10 10 10 10 42 42 42 42 10 10 10 10 10 10 10 10 10 10 10 10 10 10 10 41 10 10 10 10 10 10 10 10 10 10 10 10 10 41 41 10 10 10 10 10 10 10 10 10 10 12 12 12 12 40 40 40 10 10 10 10 10 10 10 10 10 10 10 10 10 10 10 10 10 10 10 10 10 40 40 40 12 12 12 12
12 12 12 12 10 10 10 10 10 10 10 10 10 10 10 10 10 10 10 10 41 41 41 10 10 10 10 10 10 10 10 10 10 10 10 10 10 10 10 42 10 10 10 10 10 10 10 10 10 10 10 10 10 42 42 10 10 10 10 10 10 10 10 10 10 12 12 12 12 40 40 40 10 10 10 10 10 10 10 10 10 10 10 10 10 10 10 10 10 10 10 10 10 40 40 40 12 12 12 12
12 12 12 12 41 41 41 41 41 10 10 10 10 10 10 41 41 41 41 41 42 42 42 10 10 10 10 10 10 10 10 10 10 10 10 10 10 10 10 41 10 10 10 10 10 10 10 10 10 10 10 10 10 41 41 10 10 10 10 10 10 10 10 10 10 12 12 12 12 40 40 40 10 10 10 10 10 10 10 10 10 10 10 10 10 10 10 10 10 10 10 10 10 40 40 40 12 12 12 12
12 12 12 12 42 42 42 42 42 10 10 10 10 10 10 42 42 42 42 42 10 41 41 10 10 10 10 10 10 41 41 41 41 41 41 41 41 41 41 41 10 10 10 10 10 10 10 10 10 10 10 10 10 42 42 10 10 10 10 10 10 10 10 10 10 12 12 12 12 40 40 40 40 40 40 40 40 40 40 40 40 40 40 40 40 40 40 40 40 40 40 40 40 40 40 40 12 12 12 12
12 12 12 12 41 41 41 41 41 10 10 10 10 10 10 41 41 41 41 41 41 42 42 41 10 10 10 10 41 42 42 42 42 42 42 42 42 42 42 42 10 10 10 10 10 10 10 10 10 10 10 10 10 41 41 10 10 10 10 10 10 10 10 10 10 12 12 12 12 12 12 12 12 12 12 12 12 12 12 12 12 12 12 12 12 12 12 12 12 12 12 12 12 12 12 12 12 12 12 12
12 12 12 12 42 42 42 42 42 10 10 10 10 10 10 42 42 42 42 42 42 10 10 42 10 10 10 10 42 41 41 41 41 41 41 41 41 41 41 41 10 10 10 10 10 10 10 10 10 10 10 10 10 42 42 10 10 10 10 10 10 10 10 10 10 12 12 12 12 12 12 12 12 12 12 12 12 12 12 12 12 12 12 12 12 12 12 12 12 12 12 12 12 12 12 12 12 12 12 12
12 12 12 12 41 41 41 41 41 10 10 10 10 10 10 41 41 41 41 41 41 41 41 41 10 10 10 10 41 42 42 42 42 42 42 42 42 42 42 42 10 10 10 10 10 10 10 10 10 10 10 10 10 41 41 10 10 10 10 10 10 10 10 10 10 12 12 12 12 12 12 12 12 12 12 12 12 12 12 12 12 12 12 12 12 12 12 12 12 12 12 12 12 12 12 12 12 12 12 12
12 12 12 12 42 42 42 42 42 10 10 10 10 10 10 42 42 42 42 42 42 42 42 42 10 10 10 41 42 41 41 41 41 41 41 41 41 41 41 41 10 10 10 10 10 10 10 10 10 10 10 10 10 42 42 10 10 10 10 10 10 10 10 10 10 12 12 12 12 12 12 12 12 12 12 12 12 12 12 12 12 12 12 12 12 12 12 12 12 12 12 12 12 12 12 12 12 12 12 12
12 12 12 12 41 41 41 41 41 10 10 10 10 10 10 41 41 41 41 41 41 41 41 41 10 10 10 42 41 42 42 42 42 42 42 42 42 42 42 42 10 10 10 10 10 10 10 10 10 10 10 10 10 41 41 10 10 10 10 10 10 10 10 10 10 41 41 41 10 10 10 10 10 10 10 10 10 10 10 10 10 10 10 10 10 10 10 10 10 10 10 10 10 10 10 10 12 12 12 12
12 12 12 12 42 42 42 42 42 10 10 10 10 10 10 42 42 42 42 42 42 42 42 42 10 10 10 41 42 41 41 41 41 41 41 41 41 41 41 41 10 10 10 10 10 10 10 10 10 10 10 10 10 42 42 10 10 10 10 10 10 10 10 10 10 42 42 42 10 10 10 10 10 10 10 10 10 10 10 10 10 10 10 10 10 10 10 10 10 10 10 10 10 10 10 10 12 12 12 12
12 12 12 12 41 41 41 41 41 10 10 10 10 10 10 41 41 41 41 41 41 41 41 41 10 10 10 42 10 42 42 42 42 42 42 42 42 42 42 42 10 10 10 10 10 10 10 10 10 10 10 10 10 41 41 10 10 10 10 10 10 10 10 10 10 41 41 41 10 10 10 10 10 10 10 10 10 10 10 10 10 10 10 10 10 10 10 10 10 10 10 10 10 10 10 12 12 12 12 12
12 12 12 12 42 42 42 42 42 10 10 10 10 10 10 42 42 42 42 42 42 42 42 42 10 10 10 10 10 10 10 10 10 10 10 10 10 10 41 41 10 10 10 10 10 10 10 10 10 10 10 10 10 42 42 10 10 10 10 10 10 10 10 10 10 42 42 42 10 10 10 10 10 10 10 10 10 10 10 10 10 10 10 10 10 10 10 10 10 10 10 10 10 10 10 12 12 12 12 12
12 12 12 12 41 41 41 41 41 10 10 10 10 10 10 41 41 41 41 41 41 41 41 41 10 10 10 10 10 10 10 10 10 10 10 10 10 10 42 42 10 10 10 10 10 10 10 10 10 10 10 10 10 41 41 10 10 10 10 10 10 10 10 10 10 41 41 41 10 10 10 10 10 10 10 10 10 10 10 10 10 10 10 10 10 10 10 10 10 10 10 10 10 10 10 10 12 12 12 12
12 12 12 12 42 42 42 42 42 10 10 10 10 10 10 42 42 42 42 42 42 42 42 42 10 10 10 10 10 10 10 10 10 10 10 10 10 10 41 41 10 10 10 10 10 10 10 10 10 10 10 10 10 42 42 10 10 10 10 10 10 10 10 10 10 42 42 42 10 10 10 10 10 10 10 10 10 10 10 10 10 10 10 10 10 10 10 10 10 10 10 10 10 10 10 10 12 12 12 12
12 12 12 12 10 10 10 10 10 10 10 10 10 10 10 10 10 10 10 10 41 41 41 41 41 41 41 41 41 41 41 41 41 41 41 10 10 10 42 42 10 10 10 10 10 10 10 10 10 10 10 10 10 41 41 10 10 10 10 10 10 10 10 10 10 41 41 41 10 10 10 10 10 10 10 10 10 10 10 10 10 10 10 10 10 10 10 10 10 10 10 10 10 10 10 10 12 12 12 12
12 12 12 12 10 10 10 10 10 10 10 10 10 10 10 10 10 10 10 10 42 42 42 42 42 42 42 42 42 42 42 42 42 42 42 10 10 10 10 41 10 10 10 10 10 10 10 10 10 10 10 10 10 42 42 10 10 10 10 10 10 10 10 10 10 42 42 42 10 10 10 10 10 10 10 10 10 10 10 10 10 10 10 10 10 10 10 10 10 10 10 10 10 10 10 10 12 12 12 12
12 12 12 12 10 10 10 10 10 10 10 10 10 10 10 10 10 10 10 10 10 10 10 10 10 10 10 10 10 10 10 10 10 10 10 10 10 10 10 42 10 10 10 10 10 10 10 10 10 10 10 10 10 41 41 10 10 10 10 10 10 10 10 10 10 41 41 41 10 10 10 10 10 10 10 10 10 10 10 10 10 10 10 10 10 10 10 10 10 10 10 10 10 10 10 10 12 12 12 12
12 12 12 12 10 10 10 10 10 10 10 10 10 10 10 10 10 10 10 10 10 10 10 10 10 10 10 10 10 10 10 10 10 10 10 10 10 10 10 41 10 10 10 10 10 10 10 10 10 10 10 10 10 42 42 10 10 10 10 10 10 10 10 10 10 42 42 42 10 10 10 10 10 10 10 10 10 10 10 10 10 10 10 10 10 10 10 10 10 10 10 10 10 10 10 10 12 12 12 12
12 12 12 12 10 10 10 10 10 10 10 10 10 10 10 10 10 10 10 10 10 10 10 10 10 10 10 10 10 10 10 10 10 10 10 10 10 10 10 42 10 10 10 10 10 10 10 10 10 10 10 10 10 10 10 10 10 10 10 10 10 10 10 10 10 41 41 41 10 10 10 10 10 10 10 10 10 10 10 10 10 10 10 10 10 10 10 10 10 10 10 10 10 10 10 10 12 12 12 12
12 12 12 12 10 10 10 10 10 10 10 10 10 10 10 10 10 10 10 10 10 10 10 10 10 10 10 10 10 10 10 10 10 10 10 10 41 41 41 41 10 10 10 10 10 10 10 10 10 10 10 10 10 10 10 10 10 10 10 10 10 10 10 10 10 42 42 42 10 10 10 10 10 10 10 10 10 10 10 10 10 10 10 10 10 10 10 10 10 10 10 10 10 10 10 10 12 12 12 12
12 12 12 12 10 10 10 10 10 10 10 10 10 10 10 10 10 10 10 10 41 41 41 41 41 41 41 41 41 41 41 41 41 41 41 41 42 42 42 42 10 10 10 10 10 10 10 10 10 10 10 10 10 10 10 10 10 10 10 10 10 10 10 10 10 41 41 41 10 10 10 10 10 10 10 10 10 10 10 10 10 10 10 10 10 10 10 10 10 10 10 10 10 10 10 10 12 12 12 12
12 12 12 12 10 10 10 10 10 10 10 10 10 10 10 10 10 10 10 10 42 42 42 42 42 42 42 42 42 42 42 42 42 42 42 42 41 41 41 41 10 10 10 10 10 10 10 10 10 10 10 10 10 10 10 10 10 10 10 10 10 10 10 10 10 42 42 42 10 10 10 10 10 10 10 10 10 10 10 10 10 10 10 10 10 10 10 10 10 10 10 10 10 10 10 10 12 12 12 12
12 12 12 12 10 10 10 10 10 10 10 10 10 10 10 10 10 10 10 10 10 10 10 10 10 10 10 10 10 10 10 10 10 10 10 10 42 42 42 42 10 10 10 10 10 10 10 10 10 10 10 10 10 10 10 10 10 10 10 10 10 10 10 10 10 41 41 41 10 10 10 10 10 10 10 10 10 10 10 10 10 10 10 10 10 10 10 10 10 10 10 10 10 10 10 10 12 12 12 12
12 12 12 12 10 10 10 10 10 10 10 10 10 10 10 10 10 10 10 10 10 10 10 10 10 10 10 10 10 10 10 10 10 10 10 10 41 41 41 41 10 10 10 10 10 10 10 10 10 10 10 10 10 10 10 10 10 10 10 10 10 10 10 10 10 42 42 42 10 10 10 10 10 10 10 10 10 10 10 10 10 10 10 10 10 10 10 10 10 10 10 10 10 10 10 10 12 12 12 12
12 12 12 12 10 10 10 10 10 10 10 10 10 10 10 10 10 10 10 10 10 10 10 10 10 10 10 10 10 10 10 10 10 10 10 10 42 42 42 42 10 10 10 10 10 10 10 10 10 10 10 10 10 10 10 10 10 10 10 10 10 10 10 10 10 41 41 41 10 10 10 10 10 10 10 10 10 10 10 10 10 10 10 10 10 10 10 10 10 10 10 10 10 10 10 10 12 12 12 12
12 12 12 12 41 41 41 41 41 41 41 41 41 41 41 41 41 41 41 41 41 41 41 41 41 41 41 41 41 41 41 41 41 41 41 41 41 41 41 41 10 10 10 10 10 10 10 10 10 10 10 10 10 10 10 10 10 10 10 10 10 10 10 10 10 42 42 42 10 10 10 10 10 10 10 10 10 10 10 10 10 10 10 10 10 10 10 10 10 10 10 10 10 10 10 10 12 12 12 12
12 12 12 12 42 42 42 42 42 42 42 42 42 42 42 42 42 42 42 42 42 42 42 42 42 42 42 42 42 42 42 42 42 42 42 42 42 42 42 42 10 10 10 10 10 10 10 10 10 10 10 10 10 10 10 10 10 10 10 10 10 10 10 10 10 41 41 41 10 10 10 10 10 10 10 10 10 10 10 10 10 10 10 10 10 10 10 10 10 10 10 10 10 10 10 10 12 12 12 12
12 12 12 12 10 10 10 10 10 10 10 10 10 10 10 10 10 10 10 10 10 10 10 10 10 10 10 10 10 10 10 10 10 10 10 10 10 10 10 10 10 10 10 10 10 10 10 10 10 10 10 10 10 10 10 10 10 10 10 10 10 10 10 10 10 42 42 42 10 10 10 10 10 10 10 10 10 10 10 10 10 10 10 10 10 10 10 10 10 10 10 10 10 10 10 10 12 12 12 12
12 12 12 12 10 10 10 10 10 10 10 10 10 10 10 10 10 10 10 10 10 10 10 10 10 10 10 10 10 10 10 10 10 10 10 10 10 10 10 10 10 10 10 10 10 10 10 10 10 10 10 10 10 10 10 10 10 10 10 10 10 10 10 10 10 41 41 41 10 10 10 10 10 10 10 10 10 10 10 10 10 10 10 10 10 10 10 10 10 10 10 10 10 10 10 10 12 12 12 12
12 12 12 12 10 10 10 10 10 10 10 10 10 10 10 10 10 10 10 10 10 10 10 10 10 10 10 10 10 10 10 10 10 10 10 10 10 10 10 10 10 10 10 10 10 10 10 10 10 10 10 10 10 10 10 10 10 10 10 10 10 10 10 10 10 42 42 42 10 10 10 10 10 10 10 10 10 10 10 10 10 10 10 10 10 10 10 10 10 10 10 10 10 10 10 10 12 12 12 12
12 12 12 12 10 10 10 10 10 10 10 10 10 10 10 10 10 10 10 10 10 10 10 10 10 10 10 10 10 10 10 10 10 10 10 10 10 10 10 10 10 10 10 10 10 10 10 10 10 10 10 10 10 10 10 10 10 10 10 10 10 10 10 10 10 41 41 41 10 10 10 10 10 10 10 10 10 10 10 10 10 10 10 10 10 10 10 10 10 10 10 10 10 10 10 10 12 12 12 12
12 12 12 12 10 10 10 10 10 10 10 10 10 10 10 10 10 10 10 10 10 10 10 10 10 10 10 10 10 10 10 10 10 10 10 10 10 10 10 10 10 10 10 10 10 10 10 10 10 10 10 10 10 10 10 10 10 10 10 10 10 10 10 10 10 42 42 42 10 10 10 10 10 10 10 10 10 10 10 10 10 10 10 10 10 10 10 10 10 10 10 10 10 10 10 10 12 12 12 12
12 12 12 12 10 10 10 10 10 10 41 41 41 41 41 41 41 41 41 10 10 10 10 10 10 10 10 10 10 10 10 10 10 10 10 10 10 10 10 10 10 10 10 10 10 10 10 10 10 10 10 10 10 10 10 10 10 10 10 10 10 10 10 10 10 41 41 41 10 10 10 10 10 10 10 10 10 10 10 10 10 10 10 10 10 10 10 10 10 10 10 10 10 10 10 10 12 12 12 12
12 12 12 12 10 10 10 10 10 10 42 42 42 42 42 42 42 42 42 41 10 10 10 10 10 10 10 10 10 10 10 10 10 10 10 10 10 10 10 10 10 10 10 10 10 10 10 10 10 10 10 10 10 10 10 10 10 10 10 10 10 10 10 10 10 42 42 42 10 10 10 10 10 10 10 10 10 10 10 10 10 10 10 10 10 10 10 10 10 10 10 10 10 10 10 10 12 12 12 12
12 12 12 12 10 10 10 10 10 10 10 10 10 10 10 41 41 41 41 42 10 10 10 10 10 10 10 10 10 10 10 10 10 10 10 10 10 10 10 10 10 10 10 10 10 10 10 10 10 10 10 10 10 10 10 10 10 10 10 10 10 10 10 10 10 41 41 41 10 10 10 10 10 10 10 10 10 10 10 10 10 10 10 10 10 10 10 10 10 10 10 10 10 10 10 10 12 12 12 12
12 12 12 12 10 10 10 10 10 41 41 41 41 41 41 42 42 42 42 41 10 10 10 10 10 10 10 10 10 10 10 10 10 10 10 10 10 10 10 10 10 10 10 10 10 10 10 10 10 10 10 10 10 10 10 10 10 10 10 10 10 10 10 10 10 42 42 42 10 10 10 10 10 10 10 10 10 10 10 10 10 10 10 10 10 10 10 10 10 10 10 10 10 10 10 10 12 12 12 12
12 12 12 12 10 10 10 10 10 42 42 42 42 42 42 41 41 41 41 42 10 10 10 10 10 10 10 10 10 10 10 10 10 10 10 10 10 10 10 10 10 10 10 10 10 10 10 10 10 10 10 10 10 10 10 10 10 10 10 10 10 10 10 10 10 41 41 41 10 10 10 10 10 10 10 10 10 10 10 10 10 10 10 10 10 10 10 10 10 10 10 10 10 10 10 10 12 12 12 12
12 12 12 12 10 10 10 10 10 41 41 41 41 41 41 42 42 42 42 41 10 10 10 10 10 10 10 10 10 10 10 10 10 10 10 10 10 10 10 10 10 10 10 10 10 10 10 10 10 10 10 10 10 10 10 10 10 10 10 10 10 10 10 10 10 42 42 42 10 10 10 10 10 10 10 10 10 10 10 10 10 10 10 10 10 10 10 10 10 10 10 10 10 10 10 10 12 12 12 12
12 12 12 12 10 10 10 10 10 42 42 42 42 42 42 41 41 41 41 42 10 10 10 10 10 10 10 10 10 10 10 10 10 10 10 10 10 10 10 10 10 10 10 10 10 10 10 10 10 10 10 10 10 10 10 10 10 10 10 10 10 10 10 10 10 41 41 41 10 10 10 10 10 10 10 10 10 10 10 10 10 10 10 10 10 10 10 10 10 10 10 10 10 10 10 10 12 12 12 12
12 12 12 12 10 10 10 10 10 41 41 41 41 41 41 42 42 42 42 41 10 10 10 10 10 10 10 10 10 10 10 10 10 10 10 10 10 10 10 10 10 10 10 10 10 10 10 10 10 10 10 10 10 10 10 10 10 10 10 10 10 10 10 10 10 42 42 42 10 10 10 10 10 10 10 10 10 10 10 10 10 10 10 10 10 10 10 10 10 10 10 10 10 10 10 10 12 12 12 12
12 12 12 12 10 10 10 10 10 42 42 42 42 42 42 41 41 41 41 42 10 10 10 10 10 10 10 10 10 10 10 10 10 10 10 10 10 10 10 10 10 10 10 10 10 10 10 10 10 10 10 10 10 10 10 10 10 10 10 10 10 10 10 10 10 41 41 41 10 10 10 10 10 10 10 10 10 10 10 10 10 10 10 10 10 10 10 10 10 10 10 10 10 10 10 10 12 12 12 12
12 12 12 12 10 10 10 10 10 41 41 10 10 10 10 42 42 42 42 41 10 10 10 10 10 10 10 10 10 10 10 10 10 10 10 10 10 10 10 10 10 10 10 10 10 10 10 10 10 10 10 10 10 10 10 10 10 10 10 10 10 10 10 10 10 42 42 42 10 10 10 10 10 10 10 10 10 10 10 10 10 10 10 10 10 10 10 10 10 10 10 10 10 10 10 10 12 12 12 12
12 12 12 12 10 10 10 10 10 42 42 10 10 10 10 10 10 10 41 42 12 12 12 12 12 12 12 12 12 12 12 12 12 12 12 12 12 12 12 12 12 12 12 12 12 12 12 41 41 41 41 10 10 10 10 10 10 10 10 10 10 41 41 41 10 41 41 41 10 10 10 10 10 10 10 10 10 10 10 10 10 10 10 10 10 10 10 10 10 10 10 10 10 10 10 10 12 12 12 12
12 12 12 12 10 10 10 10 10 10 10 10 10 10 10 10 10 10 42 41 12 12 12 12 12 12 12 12 12 12 12 12 12 12 12 12 12 12 12 12 12 12 12 12 12 12 12 42 42 42 42 10 10 10 10 10 10 10 10 10 10 42 42 42 10 42 42 42 10 10 10 10 10 10 10 10 10 10 10 10 10 10 10 10 10 10 10 10 10 10 10 10 10 10 10 10 12 12 12 12
12 12 12 12 10 10 10 10 10 10 10 41 10 10 10 41 41 10 41 42 12 12 12 12 12 12 12 12 12 12 12 12 12 12 12 12 12 12 12 12 12 12 12 12 12 12 12 41 41 41 41 10 10 10 10 10 10 10 10 10 10 41 41 41 10 41 41 41 10 10 10 10 10 10 10 10 10 10 10 10 10 10 10 10 10 10 10 10 10 10 10 10 10 10 10 10 12 12 12 12
12 12 12 12 10 10 10 10 10 10 10 42 41 41 41 42 42 41 42 41 10 10 10 10 10 10 10 10 10 10 10 10 10 10 10 10 10 10 10 10 10 10 10 10 10 10 10 42 42 42 42 10 10 10 10 10 10 10 10 10 10 42 42 42 10 42 42 42 10 10 10 10 10 10 10 10 10 10 10 10 10 10 10 10 10 10 10 10 10 10 10 10 10 10 10 10 12 12 12 12
12 12 12 12 10 10 10 10 10 10 10 10 42 42 42 10 10 42 41 42 10 10 10 10 10 10 10 10 10 10 10 10 10 10 10 10 10 10 10 10 10 10 10 10 10 10 10 41 41 41 41 10 10 10 10 10 10 10 10 10 10 41 41 41 10 41 41 41 10 10 10 10 10 10 10 10 10 10 10 10 10 10 10 10 10 10 10 10 10 10 10 10 10 10 10 10 12 12 12 12
12 12 12 12 10 10 10 10 10 10 10 10 10 10 10 10 10 10 41 41 10 10 10 10 10 10 10 10 10 10 10 10 10 10 10 10 10 10 10 10 10 10 10 10 10 10 10 42 42 42 42 10 10 10 10 10 10 10 10 10 10 42 42 42 10 42 42 42 10 10 10 10 10 10 10 10 10 10 10 10 10 10 10 10 10 10 10 10 10 10 10 10 10 10 10 10 12 12 12 12
12 12 12 12 10 10 10 10 10 10 10 10 10 10 10 10 10 10 42 42 10 10 10 10 10 10 10 10 10 10 10 10 10 10 10 10 10 10 10 10 10 10 10 10 10 10 10 41 41 41 41 10 10 10 10 10 10 10 10 10 10 41 41 41 10 41 41 41 10 10 10 10 10 10 10 10 10 10 10 10 10 10 10 10 10 10 10 10 10 10 10 10 10 10 10 10 12 12 12 12
12 12 12 12 10 10 10 10 10 10 10 10 10 10 10 10 10 10 41 41 10 10 10 10 10 10 10 10 10 10 10 10 10 10 10 10 10 10 10 10 10 10 10 10 10 10 10 42 42 42 42 10 10 10 10 10 10 10 10 10 10 42 42 42 10 42 42 42 10 10 10 10 10 10 10 10 10 10 10 10 10 10 10 10 10 10 10 10 10 10 10 10 10 10 10 10 12 12 12 12
12 12 12 12 10 10 10 10 10 10 10 10 10 10 10 10 10 10 42 42 10 10 10 10 10 10 10 41 41 41 41 41 41 41 41 41 41 41 41 41 10 10 10 10 10 10 10 41 41 41 41 10 10 10 10 10 10 10 10 10 10 41 41 41 10 41 41 41 10 10 10 10 10 10 10 10 10 10 10 10 10 10 10 10 10 10 10 10 10 10 10 10 10 10 10 10 12 12 12 12
12 12 12 12 10 10 10 10 10 10 10 10 10 10 10 10 10 10 41 41 10 10 10 10 10 10 10 42 42 42 42 42 42 42 42 42 42 42 42 42 10 10 10 10 10 10 10 42 42 42 42 10 10 10 10 10 10 10 10 10 10 42 42 42 10 42 42 42 10 10 10 10 10 10 10 10 10 10 10 10 10 10 10 10 10 10 10 10 10 10 10 10 10 10 10 10 12 12 12 12
12 12 12 12 10 10 10 10 10 10 10 10 10 10 10 10 10 10 42 42 10 10 10 10 10 10 10 41 10 10 10 10 10 10 10 10 10 41 41 41 10 10 10 10 10 10 41 41 41 41 41 10 10 10 10 10 10 10 10 10 10 41 41 41 10 41 41 41 10 10 10 10 10 10 10 10 10 10 10 10 10 10 10 10 10 10 10 10 10 10 10 10 10 10 10 10 12 12 12 12
12 12 12 12 10 10 10 10 10 10 10 10 10 10 10 10 10 10 10 41 10 10 10 10 10 10 10 42 10 10 10 10 10 10 10 10 10 42 42 42 10 10 10 10 10 10 42 42 42 42 42 10 10 10 10 10 10 10 10 10 10 42 42 42 10 42 42 42 10 10 10 10 10 10 10 10 10 10 10 10 10 10 10 10 10 10 10 10 10 10 10 10 10 10 10 10 12 12 12 12
12 12 12 12 10 10 10 10 10 10 10 10 10 10 10 10 10 10 41 42 10 10 10 10 10 10 10 10 10 10 10 10 10 10 10 10 10 41 41 41 10 10 10 10 10 10 41 41 41 41 41 10 10 10 10 10 10 10 10 10 10 41 41 41 10 41 41 41 10 10 10 10 10 10 10 10 10 10 10 10 10 10 10 10 10 10 10 10 10 10 10 10 10 10 10 10 12 12 12 12
12 12 12 12 10 10 10 10 10 10 10 10 10 10 10 10 10 10 42 41 10 10 10 10 10 10 10 10 10 10 10 10 10 10 10 10 10 42 42 42 10 10 10 10 10 10 42 42 42 42 42 10 10 10 10 10 10 10 10 10 10 42 42 42 10 42 42 42 10 10 10 10 10 10 10 10 10 10 10 10 10 10 10 10 10 10 10 10 10 10 10 10 10 10 10 10 12 12 12 12
12 12 12 12 10 10 10 10 10 10 10 10 10 10 10 10 10 10 41 42 10 10 10 10 10 10 10 41 10 10 10 10 10 10 10 10 10 41 41 41 10 10 10 10 10 10 41 41 41 41 41 10 10 10 10 10 10 10 10 10 10 41 41 41 10 41 41 41 10 10 10 10 10 10 10 10 10 10 10 10 10 10 10 10 10 10 10 10 10 10 10 10 10 10 10 10 12 12 12 12
12 12 12 12 10 10 10 10 10 10 41 41 41 41 41 41 41 41 42 41 10 10 10 10 10 10 10 42 10 10 10 10 10 10 10 10 10 42 42 42 10 10 10 10 10 10 42 42 42 42 42 10 10 10 10 10 10 10 10 10 10 42 42 42 10 42 42 42 10 10 10 10 10 10 10 10 10 10 10 10 10 10 10 10 10 10 10 10 10 10 10 10 10 10 10 10 12 12 12 12
12 12 12 12 10 10 10 10 10 10 42 42 42 42 42 42 42 42 10 42 10 10 10 10 10 10 10 41 41 41 41 41 41 41 41 41 41 41 41 41 10 10 10 10 10 10 41 41 41 41 41 41 10 10 10 10 10 10 10 10 10 41 41 41 10 41 41 41 10 10 10 10 10 10 10 10 10 10 10 10 10 10 10 10 10 10 10 10 10 10 10 10 10 10 10 10 10 12 12 12
12 12 12 12 10 10 10 10 10 10 41 41 41 41 41 41 41 41 41 41 10 10 10 10 10 10 10 42 42 42 42 42 42 42 42 42 42 42 42 42 10 10 10 10 10 10 42 42 42 42 42 42 10 10 10 10 10 10 10 10 10 42 42 42 10 42 42 42 10 10 10 10 10 10 10 10 10 10 10 10 10 10 10 10 10 10 10 10 10 10 10 10 10 10 10 10 10 12 12 12
12 12 12 12 10 10 10 10 10 10 42 42 42 42 42 42 42 42 42 42 10 10 10 10 10 10 10 41 41 41 41 41 41 41 41 41 41 41 41 10 10 10 10 10 10 10 41 41 41 41 41 10 10 10 10 10 10 10 10 10 10 41 41 41 10 41 41 41 10 10 10 10 10 10 10 10 10 10 10 10 10 10 10 10 10 10 10 10 10 10 10 10 10 10 10 12 12 12 12 12
12 12 12 12 10 10 10 10 10 10 10 10 10 10 10 10 10 10 10 10 10 10 10 10 10 10 10 42 42 42 42 42 42 42 42 42 42 42 42 10 10 10 10 10 10 10 42 42 42 42 42 10 10 10 10 10 10 10 10 10 10 42 42 42 10 42 42 42 10 10 10 10 10 10 10 10 10 10 10 10 10 10 10 10 10 10 10 10 10 10 10 10 10 10 10 12 12 12 12 12
12 12 12 12 10 10 10 10 10 10 10 10 10 10 10 10 10 10 10 10 10 10 10 10 10 10 10 41 41 41 41 41 41 41 41 41 41 41 10 10 10 10 10 10 10 10 10 41 41 41 41 41 10 10 10 10 10 10 10 10 10 41 41 41 10 41 41 41 10 10 10 10 10 10 10 10 10 10 10 10 10 10 10 10 10 10 10 10 10 10 10 10 10 10 10 10 12 12 12 12
12 12 12 12 10 10 10 10 10 10 10 10 10 10 10 10 10 10 10 10 10 10 10 10 10 10 10 42 42 42 42 42 42 42 42 42 42 42 10 10 10 10 10 10 10 10 10 42 42 42 42 42 10 10 10 10 10 10 10 10 10 42 42 42 10 42 42 42 10 10 10 10 10 10 10 10 10 10 10 10 10 10 10 10 10 10 10 10 10 10 10 10 10 10 10 10 12 12 12 12
12 12 12 12 10 10 10 10 10 10 10 10 10 10 10 10 10 10 10 10 10 10 10 10 10 10 10 41 41 41 41 41 41 41 41 41 41 41 10 10 10 10 10 10 10 10 10 10 41 41 41 41 10 10 10 10 10 10 10 10 10 41 41 41 10 41 41 41 10 10 10 10 10 10 10 10 10 10 10 10 10 10 10 10 10 10 10 10 10 10 10 10 10 10 10 10 10 12 12 12
12 12 12 12 10 10 10 10 10 10 10 10 10 10 10 10 10 10 10 10 10 10 10 10 10 10 10 42 42 42 42 42 42 42 42 42 42 42 10 10 10 10 10 10 10 10 10 10 42 42 42 42 10 10 10 10 10 10 10 10 10 42 42 42 10 42 42 42 10 10 10 10 10 10 10 10 10 10 10 10 10 10 10 10 10 10 10 10 10 10 10 10 10 10 10 10 10 12 12 12
12 12 12 12 12 12 12 12 12 12 12 12 12 12 12 12 12 12 12 12 12 12 12 12 12 12 12 12 12 12 12 12 12 12 12 12 12 12 12 12 12 12 12 12 12 12 12 12 12 12 12 12 12 12 12 12 12 12 12 12 12 12 12 12 12 12 12 12 12 12 12 12 12 12 12 12 12 12 12 12 12 12 12 12 12 12 12 12 12 12 12 12 12 12 12 12 12 12 12 12
12 12 12 12 12 12 12 12 12 12 12 12 12 12 12 12 12 12 12 12 12 12 12 12 12 12 12 12 12 12 12 12 12 12 12 12 12 12 12 12 12 12 12 12 12 12 12 12 12 12 12 12 12 12 12 12 12 12 12 12 12 12 12 12 12 12 12 12 12 12 12 12 12 12 12 12 12 12 12 12 12 12 12 12 12 12 12 12 12 12 12 12 12 12 12 12 12 12 12 12
12 12 12 12 12 12 12 12 12 12 12 12 12 12 12 12 12 12 12 12 12 12 12 12 12 12 12 12 12 12 12 12 12 12 12 12 12 12 12 12 12 12 12 12 12 12 12 12 12 12 12 12 12 12 12 12 12 12 12 12 12 12 12 12 12 12 12 12 12 12 12 12 12 12 12 12 12 12 12 12 12 12 12 12 12 12 12 12 12 12 12 12 12 12 12 12 12 12 12 12
12 12 12 12 12 12 12 12 12 12 12 12 12 12 12 12 12 12 12 12 12 12 12 12 12 12 12 12 12 12 12 12 12 12 12 12 12 12 12 12 12 12 12 12 12 12 12 12 12 12 12 12 12 12 12 12 12 12 12 12 12 12 12 12 12 12 12 12 12 12 12 12 12 12 12 12 12 12 12 12 12 12 12 12 12 12 12 12 12 12 12 12 12 12 12 12 12 12 12 12